NO ./textures/bluestone.png
SO ./textures/redbrick.png
WE ./textures/greystone.png
EA ./textures/mossy.png

F 0,250,0
C 0,0,255

111111111111111111111111111111111111111111111
100101000000000000000010100100000000000011101
110000001110010001001011111100000000110001101
100000110101000100011011111111110000111111111
100101000000000000000010100100000000000011101
110000001110010001001011111100000000110001101
100000110101000100011011111000111111111111111
1W0101000000000000000010100100000000000011101
110000001110010001001011111100000000110001101
1000001101010001000110111111111111111110001111
100101000000000000000010100100000000000011101
110000001110010001001011111100000000110001101
100000110101000100011011111000000001111111111
100101000000000000000010100100000000000011101
110000001110010001001011111100000000110001101
100000110101000100011011111111100001111111111
100101000000000000000010100100000000000011101
110000001110010001001011111100000000110001101
100000110101000100011011111111111111111111111
100101000000000000000010100100000000000011101
110000001110010001001011111100000000110001101
100000110101000100011011111111110000111111111
100101000000000000000010100100000000000011101
110000001110010001001011111100000000110001101
100000110101000100011011111000111111111111111
100101000000000000000010100100000000000011101
110000001110010001001011111100000000110001101
1000001101010001000110111111111111111110001111
100101000000000000000010100100000000000011101
110000001110010001001011111100000000110001101
100000110101000100011011111000000001111111111
100101000000000000000000000100000000000011101
110000001110010001001011111100000000110001101
100000110101000100011011111111100001111111111
100101000000000000000010100100000000000011101
110000001110010001001011111100000000110001101
100000110101000100011000000000000000000000001
111111111111111111111111111111111111111111111