NO ./textures/bluestone.png
SO ./textures/redbrick.png
WE ./textures/greystone.png
EA ./textures/mossy.png

F 0,250,0
C 0,0,255

111111111111
1001010000S111111111
1010010000000000001111
1100000011100100010011
1111110000000011000111
100000110101000100011
 100001000001001011
  1111111000000001
        100001001
         10011111
          101
          101
        110001
11111111000001
1000000000001
100000000001
 10000000011
  100001001
   11111111